1 13 31
###############################
#p     s* *  1 *   *  * * *   #
# # # #*# # #*#*# # # #*#*#*# #
#  x*     b**  *   1  *   * * #
# # # #b# #*# # #*#*# # # # #*#
#f3        x **  *  *    1    #
# # # # # # # # # #*# #*# # # #
#*  *   1  *  *      *        #
# # # # #*# # # #*#*# # # # # #
#*    **  *       *     2     #
# #*# # # # # # #*# # # # # # #
#     1     * 1 *  *          #
###############################